5 6
 - - - - - - 
|. . . . . F|
             
|. . . . . .|
             
|. . . . . .|
             
|. . . . . .|
             
|S . . . . .|
 - - - - - - 